#  ############################
#        #              #     #
#######  ####  ####  #######  #
#     #     #  #        #     #
#  ####  ####  #######  #  #  #
#              #  #  #  #  #  #
#######  #######  #  #  #  ####
#     #  #        #           #
#  #  #  ####  ##########  ####
#  #              #           #
############################  #