   ############################
         #              #     #
#######  ####  ####  #######  #
#     #     #  #        #     #
#  ####  ####  #######  #  #  #
#              #  #  #  #  #  #
#######  #######  #  #  #  ####
#     #  #        #           #
#  #  #  ####  ##########  ####
#  #              #           
############################  

