#  ############################
#        #     #  #        #  #
####  ####  ####  ####  #  #  #
#                       #  #  #
#######  #######  #######  #  #
#     #        #     #  #     #
####  ####  ##########  ####  #
#        #  #     #  #  #     #
####  ####  ####  #  #  #  #  #
#              #           #  #
############################  #