#  ############################
#        #              #     #
#  #### ##  #  #######  #  #  #
#     #     #  #           #  #
#######  #  ####  ##########  #
#     #  #  #           #     #
####  #  #############  #######
#        #        #  #        #
####  ####  #######  #  #######
#                    #        #
############################  # 